%%%%%%%%%%%%%%%%%%%%
%o...%........%....%
%.%%.%.%%%%%%.%.%%.%
%.%..............%.%
%.%.%%.      .%%.%.%
%...... GGGG ......%
%.%.%%.      .%%.%.%
%.%..............%.%
%.%%.%.%%%%%%.%.%%.%
%....%...P....%...o%
%%%%%%%%%%%%%%%%%%%%
